[A] Preview
18 20
62 160 160 416 160 160 416 160 60 61 62 421 454 394 360 454 454 396 419 193
330 416 18 19 20 160 160 416 395 425 329 454 394 418 488 454 361 486 332 28
454 426 50 51 52 160 326 395 454 454 454 394 193 193 418 456 458 322 358 60
489 454 329 329 396 395 454 454 454 454 455 193 193 28 29 30 454 425 428 328
418 453 454 492 193 456 454 556 491 454 364 418 193 60 61 62 454 454 553 454
424 454 362 416 193 491 458 417 193 360 329 332 418 331 329 454 393 394 419 456
454 454 454 426 193 193 360 330 419 363 454 454 329 454 454 428 419 193 193 427
148 94 95 454 330 416 488 428 424 79 80 81 454 454 428 28 29 25 94 95
120 126 127 454 458 193 193 193 488 111 112 113 454 458 419 60 61 57 126 127
160 488 425 454 454 332 193 418 331 454 454 454 393 454 460 328 425 454 361 426
576 577 491 454 361 454 425 425 454 489 454 458 419 456 454 361 454 454 454 428
608 609 424 454 490 491 492 392 492 419 363 428 552 454 454 454 361 454 428 417
459 425 454 490 193 419 193 193 75 193 193 74 75 488 489 393 454 394 419 193
454 486 458 419 6 493 591 592 589 881 882 589 592 591 462 583 359 6 78 109
458 419 358 193 103 620 623 624 621 276 278 621 624 623 525 462 850 591 591 494
454 425 490 417 493 526 39 418 192 368 369 192 38 583 625 620 370 623 623 588
361 490 417 192 620 626 192 192 132 270 133 192 192 38 547 620 844 845 32 588
490 419 192 192 709 192 418 236 271 271 165 192 192 192 418 620 876 32 785 588
