style -   - 00015B03
22 23
130 130 130 130 70 71 737 817 384 524 424 429 560 165 270 231 165 162 782 721 689 525 549
130 130 76 79 6 143 673 784 495 524 424 465 99 198 271 165 743 776 815 815 652 689 715
52 720 641 142 6 103 817 817 689 715 781 592 720 270 231 165 384 481 429 529 720 804 652
245 52 673 102 103 130 784 720 817 782 932 202 200 271 165 165 495 424 429 528 130 331 98
213 245 246 205 130 130 720 98 130 98 98 236 305 231 130 384 524 424 429 592 67 720 74
213 213 312 237 130 130 817 165 782 131 165 132 132 815 749 550 523 425 465 720 162 98 72
193 193 194 130 130 130 130 130 70 71 98 720 782 932 781 615 555 616 429 497 162 98 142
225 225 226 130 130 130 98 130 142 143 130 130 130 130 130 594 587 513 429 528 162 720 142
257 257 258 130 130 720 130 130 142 6 79 71 720 130 130 493 524 587 544 465 720 162 102
213 213 214 205 130 130 130 130 102 6 6 6 79 71 130 720 594 525 424 429 963 162 162
21 214 231 130 130 130 130 130 130 142 6 6 6 143 99 131 131 689 747 592 653 162 162
720 641 130 130 130 130 130 130 130 102 111 6 6 143 130 131 783 815 815 782 782 162 742
804 675 130 720 130 130 165 130 130 720 130 102 111 103 130 720 783 815 815 782 782 384 544
238 130 130 141 130 130 165 130 130 130 130 130 130 99 720 783 815 787 754 782 782 495 424
130 130 70 143 130 130 720 99 130 130 130 130 130 99 720 783 815 754 721 815 655 524 424
773 108 111 103 130 641 99 99 99 130 720 163 720 162 99 720 815 720 782 352 549 418 618
199 672 740 978 979 980 641 99 140 130 642 684 742 720 99 720 815 720 752 481 583 746 560
246 273 199 672 773 720 737 162 142 71 674 752 426 529 130 685 776 778 424 618 592 652 899
245 313 246 273 199 672 769 162 142 143 130 495 459 496 98 720 685 752 616 560 652 99 238
213 245 245 313 246 199 130 70 6 103 591 525 459 465 720 67 652 559 780 653 720 99 198
213 213 213 213 312 271 130 142 143 782 495 525 491 429 497 67 783 782 783 783 99 99 270
213 213 213 213 245 246 199 142 143 165 495 524 525 481 465 783 783 783 783 783 720 720 230
