style -   - 00051205
25 30
911 932 815 775 776 777 130 130 559 549 616 583 424 492 429 492 888 916 775 776 777 690 525 545 428 428 492 492 917 690
272 163 194 810 811 809 130 784 784 559 545 429 618 492 460 917 862 784 807 811 812 690 559 459 428 492 492 917 854 944
230 401 199 839 843 841 130 784 783 655 616 492 492 492 917 798 943 944 839 843 841 932 591 616 428 492 918 798 853 976
130 270 271 130 331 784 784 783 591 522 429 492 492 919 932 853 975 976 130 331 130 655 616 428 492 492 917 854 66 70
163 230 176 163 163 163 784 783 495 456 492 492 888 917 784 71 78 78 163 784 655 616 428 492 492 917 798 853 142 6
719 784 238 163 130 130 227 784 559 587 544 917 862 672 706 6 103 103 291 655 616 428 492 492 918 652 956 70 6 751
783 784 784 784 784 130 130 163 932 559 589 924 860 195 784 6 6 784 591 491 428 428 492 492 917 986 856 142 6 6
738 674 706 706 783 641 140 141 784 70 79 79 79 79 6 784 672 706 495 525 617 428 492 917 853 194 70 6 6 167
720 775 811 812 674 673 102 6 6 38 38 38 38 6 6 103 720 785 559 525 545 460 918 854 596 630 142 6 143 813
964 839 843 841 869 195 140 113 6 111 111 111 111 111 111 71 783 679 932 559 426 492 918 988 604 670 957 958 959 603
331 130 331 130 331 720 6 6 103 194 795 591 545 851 195 131 131 783 690 591 521 492 917 596 670 670 989 990 991 670
130 130 130 130 130 130 102 103 721 431 545 932 459 919 70 79 71 131 783 559 746 919 854 636 670 670 1021 1022 1023 670
291 720 130 130 130 130 291 911 784 495 459 429 429 919 102 6 6 79 71 559 746 917 853 599 635 598 6 6 6 599
932 130 130 130 130 130 720 784 721 495 616 460 429 917 131 142 6 6 6 79 71 784 70 6 6 6 6 6 103 814
815 70 79 71 130 130 911 753 591 932 460 460 917 652 131 102 6 6 6 111 103 130 142 6 6 6 6 143 66 783
815 38 38 6 784 130 911 721 495 545 460 492 949 804 259 70 6 6 103 291 795 783 102 6 6 6 111 103 66 943
815 102 38 38 71 130 721 690 495 424 429 917 754 361 131 142 6 103 784 591 545 851 690 102 111 103 783 66 783 975
194 163 142 38 143 130 785 836 559 746 917 847 847 847 131 102 103 850 849 559 746 615 580 512 851 742 814 783 783 195
641 932 102 38 38 71 130 361 195 784 407 847 847 847 131 131 945 913 640 227 784 559 525 587 578 616 851 783 943 944
838 643 194 166 38 38 71 130 784 407 415 406 814 163 163 131 977 640 131 719 932 783 495 525 556 512 460 851 975 976
838 838 641 814 142 38 38 79 477 415 415 415 814 194 79 71 705 131 195 131 227 783 495 525 587 556 459 460 851 194
838 838 838 130 166 111 38 38 950 951 951 951 951 952 6 143 784 674 131 131 131 932 559 525 525 587 491 460 465 814
838 838 838 130 130 130 166 111 1014 1015 1015 1015 1015 1016 6 143 291 705 70 71 130 291 783 495 525 525 587 427 460 851
838 838 838 838 643 814 130 130 784 378 415 415 415 406 166 167 70 79 38 103 130 130 911 559 525 525 525 491 460 460
838 838 838 838 838 641 932 291 407 415 415 415 415 438 932 70 111 111 103 130 130 130 259 783 559 525 525 587 427 460
