style -   - 00040304
28 34
258 258 258 258 258 258 258 258 258 258 258 258 258 258 5 167 168 5 258 258 258 293 258 258 258 258 258 258 258 258 258 258 258 258
183 183 183 183 183 183 183 183 183 183 183 183 183 183 70 167 168 70 183 183 183 357 183 183 183 183 183 183 183 183 183 183 183 183
484 484 484 484 484 12 483 484 484 484 484 484 12 483 484 484 484 484 484 12 483 357 483 484 12 483 484 484 484 484 12 483 484 484
481 481 481 481 481 461 486 481 481 481 12 480 461 486 481 481 481 481 481 461 486 357 12 480 461 486 481 12 480 481 461 486 481 481
481 481 481 481 482 482 481 12 480 481 461 486 481 482 12 480 481 481 12 483 481 357 462 486 481 481 481 461 486 481 481 12 480 481
12 480 481 481 482 481 481 461 486 481 481 482 481 481 461 486 482 481 461 481 134 357 134 480 481 481 481 481 33 480 481 461 486 481
461 486 482 12 480 481 5 832 835 835 835 835 836 5 258 7 481 481 481 6 258 293 258 258 6 480 12 125 126 480 481 7 258 258
481 482 482 461 486 481 291 864 865 866 866 867 900 291 182 70 480 12 480 70 182 357 63 79 70 480 461 157 158 480 481 70 79 63
481 482 482 481 12 480 291 864 865 898 898 867 900 291 483 484 481 461 486 481 481 357 483 111 483 482 482 189 190 480 12 483 111 484
481 12 480 481 461 486 291 864 865 898 898 867 900 291 480 12 480 481 481 12 480 140 480 484 482 482 482 484 484 482 461 486 484 482
481 461 481 12 480 134 291 928 930 931 929 930 900 291 480 461 486 481 481 461 486 484 12 480 482 481 481 482 12 480 482 482 482 481
12 480 481 461 486 352 7 295 5 150 295 5 295 6 325 480 481 481 12 480 481 481 461 486 481 12 480 481 461 486 482 482 12 480
461 486 481 481 481 291 37 182 72 302 303 72 183 37 291 480 481 481 461 486 481 291 480 482 481 461 486 481 481 482 482 482 461 486
5 167 169 168 5 385 70 182 70 167 168 70 183 70 5 258 264 258 325 33 352 258 258 258 7 167 169 169 168 5 258 258 258 258
238 167 169 168 238 85 449 421 418 421 418 421 418 421 238 182 265 183 384 293 385 183 183 183 238 167 169 169 168 238 183 183 183 183
421 418 421 418 421 418 12 449 420 417 420 417 420 417 421 418 421 417 239 357 239 449 12 418 421 418 421 418 421 12 452 418 421 418
418 12 449 420 418 420 44 453 417 420 417 12 449 420 417 12 416 420 417 357 449 420 44 420 417 420 417 420 417 44 203 420 417 420
420 44 453 417 420 417 420 417 420 417 420 44 453 417 420 44 453 417 420 357 33 416 420 417 420 417 420 12 419 418 420 417 420 417
417 420 417 12 416 420 418 420 417 420 417 420 417 420 417 420 417 420 417 357 417 420 417 420 417 420 417 44 450 420 418 420 12 419
420 417 420 44 453 417 420 417 12 416 420 417 420 417 420 417 12 416 420 238 420 12 419 417 420 417 420 417 420 417 420 417 44 450
417 420 417 420 417 420 417 420 44 453 417 420 12 419 417 420 44 453 417 140 417 44 450 420 417 420 12 419 417 420 418 420 417 420
12 416 420 417 420 417 420 417 420 417 420 417 44 450 420 417 453 417 420 418 420 417 420 12 419 417 44 450 420 417 420 417 420 417
44 453 417 420 12 419 417 134 352 278 278 278 278 278 325 420 417 420 418 420 417 420 417 44 352 278 278 278 278 278 278 325 134 416
420 417 420 417 44 450 420 352 385 182 184 184 184 183 384 325 419 417 420 12 419 417 420 352 385 182 184 184 184 183 183 384 325 134
417 420 417 420 418 134 352 385 182 33 449 421 418 421 140 322 416 420 417 44 450 420 417 322 238 452 12 452 418 421 418 182 384 292
352 258 258 258 258 258 353 182 452 418 420 417 420 12 452 140 419 417 420 417 420 417 420 140 452 450 44 450 12 416 421 418 182 183
291 182 183 2 183 183 291 452 417 12 416 420 417 44 450 234 417 12 416 420 417 420 417 234 417 420 417 420 44 420 417 420 418 421
291 193 132 34 132 194 291 416 420 44 453 417 420 417 420 417 420 44 420 417 420 417 12 416 420 417 420 417 420 417 420 418 420 134
