01005B03
17 23
905 720 172 173 785 736 99 967 968 969 67 23 276 276 276 26 807 904 809 166 6 6 103
969 67 67 67 67 768 773 67 331 67 67 55 276 276 26 67 935 840 841 134 6 103 57
66 67 67 67 67 720 804 674 67 67 53 276 276 124 67 817 967 968 969 142 143 57 276
67 198 303 67 70 79 71 67 67 720 125 276 276 276 52 118 720 331 67 102 143 23 276
198 231 66 684 102 111 6 79 932 57 276 276 22 21 276 276 54 896 897 898 54 55 276
401 205 66 784 784 684 102 192 193 193 193 193 194 71 125 276 276 928 929 930 276 276 276
401 237 720 782 816 723 784 256 257 257 257 257 258 143 23 276 276 928 929 930 817 23 276
401 199 782 782 815 755 914 816 221 276 276 52 720 102 77 23 20 960 961 962 71 931 21
401 271 720 720 816 804 816 53 276 22 21 276 56 720 849 850 720 142 6 6 103 238 720
401 401 199 67 720 331 53 276 124 805 817 23 124 912 913 914 817 102 6 6 71 67 67
305 401 271 67 67 67 123 276 20 331 67 53 20 944 945 946 817 720 102 644 643 817 67
67 230 231 67 720 53 276 220 720 67 720 123 52 57 56 816 754 816 644 720 67 641 720
720 67 67 192 193 193 193 193 194 79 71 21 276 276 20 816 816 817 736 807 808 809 720
67 70 137 256 257 257 257 257 258 102 143 67 23 276 52 55 95 640 720 839 840 841 67
67 142 143 67 53 276 276 276 20 67 173 67 720 27 276 20 931 672 772 871 872 873 720
70 6 143 720 91 276 276 22 720 67 67 67 4 53 122 67 238 67 67 67 362 67 67
142 6 103 53 276 276 20 817 67 70 71 67 67 21 276 56 720 67 720 67 70 79 77
