style -   - 00015B03
18 26
783 142 6 143 98 783 673 604 606 606 605 720 98 269 264 433 433 231 782 938 939 940 782 782 684 495
676 102 6 143 98 673 720 604 606 606 606 630 204 433 401 433 433 205 163 970 971 972 66 783 684 495
804 720 142 6 71 720 98 599 606 606 606 598 302 433 401 433 433 265 98 1002 1003 1004 66 66 783 594
331 98 102 111 103 98 98 880 604 606 605 98 236 177 433 433 433 271 98 758 724 790 98 98 720 684
720 98 98 98 70 71 98 98 604 606 598 98 98 720 300 336 294 231 720 791 788 792 720 131 131 783
268 269 165 165 142 6 71 720 599 605 720 98 98 98 130 130 98 131 98 98 98 98 98 131 131 720
433 271 165 165 102 6 6 596 570 670 630 720 98 742 868 684 720 131 131 131 131 131 131 131 131 99
433 231 720 165 596 320 322 629 720 599 606 630 384 544 429 497 684 98 131 131 98 720 98 98 131 98
231 596 570 603 629 142 143 130 98 642 628 629 559 587 544 460 497 720 98 131 98 98 98 720 131 868
570 629 720 601 720 102 143 130 782 736 880 880 721 559 587 544 528 868 98 98 98 98 98 868 720 677
643 98 98 599 630 70 103 720 642 807 808 809 723 786 495 521 528 744 198 199 98 98 741 740 673 782
836 641 98 70 2 172 98 98 674 871 872 873 944 720 559 781 560 720 270 271 98 673 99 162 720 99
331 720 643 142 599 630 72 71 720 130 331 130 720 130 868 782 720 131 270 433 205 99 98 99 99 99
98 98 76 103 720 632 102 6 79 71 130 130 130 130 130 162 162 67 296 433 303 99 98 99 99 99
720 98 596 570 630 632 720 102 6 143 130 130 130 130 130 131 131 98 234 336 235 98 98 198 273 199
596 34 629 720 599 635 630 98 172 173 130 720 204 273 199 131 131 131 98 98 98 98 720 270 401 401
629 98 98 130 130 98 599 630 70 77 130 130 200 401 271 720 98 98 720 743 720 99 99 230 401 401
98 98 198 273 199 130 720 2 172 130 130 198 401 401 401 199 98 900 384 512 497 782 98 720 270 401
