style -   - 00013803
32 16
433 433 433 433 199 720 98 98 98 98 98 743 130 130 67 720
230 433 433 433 271 98 98 720 742 742 591 459 718 720 130 130
720 230 433 433 271 98 98 749 581 580 418 618 560 963 130 963
497 98 270 433 271 720 98 781 615 555 616 429 529 963 963 963
560 98 270 433 433 199 98 684 594 587 545 492 429 497 743 776
647 98 230 433 433 271 98 98 782 689 747 585 579 580 514 512
206 98 720 230 305 231 98 98 98 782 684 594 587 453 619 450
230 273 199 98 268 272 203 720 98 98 720 782 559 491 583 422
723 230 295 98 230 433 201 203 98 98 162 98 684 559 545 618
492 497 782 720 98 232 433 201 203 98 98 98 720 899 559 780
429 429 718 775 202 200 433 433 265 720 98 162 162 331 162 720
623 492 560 672 234 232 433 433 271 162 202 640 720 162 468 504
549 481 649 745 674 234 232 433 233 162 236 469 740 505 437 247
430 616 496 684 642 720 236 295 235 98 162 230 401 401 401 543
524 545 429 593 672 740 673 162 162 720 162 162 270 401 247 244
555 521 496 804 720 130 162 720 162 162 162 720 230 401 543 244
416 618 560 331 162 162 268 272 162 162 162 162 162 270 215 244
522 464 593 98 162 162 270 271 162 720 162 162 162 230 401 215
747 592 720 162 162 198 305 433 199 162 162 720 162 162 270 401
570 570 630 162 198 271 720 270 231 162 162 162 162 162 230 401
162 162 599 630 230 305 273 271 162 162 162 162 162 162 720 230
654 720 162 599 570 630 230 231 162 162 720 162 162 720 162 162
720 162 162 162 162 599 928 930 630 162 162 162 162 162 162 720
162 162 162 162 720 162 162 162 599 570 570 630 162 162 162 162
162 720 162 162 162 162 720 162 198 271 899 599 570 630 162 76
934 934 934 870 162 162 720 162 230 231 331 162 162 599 570 570
978 979 980 969 70 79 71 162 720 162 162 162 162 810 811 812
162 162 162 162 142 6 103 162 162 162 162 162 720 842 843 844
978 979 980 70 6 143 162 162 162 162 162 162 162 791 788 792
162 162 162 111 111 103 720 162 162 162 162 720 162 162 162 720
978 979 980 902 720 162 162 162 162 162 162 162 162 162 162 162
934 934 934 873 162 162 162 162 720 162 162 162 162 162 720 162
