Stronghold Update Snowy 2021
32 48
244 240 241 242 243 6 241 242 243 242 243 6 241 242 243 242 243 242 293 241 242 243 242 243 242 241 242 243 242 243 242 243 242 7 241 242 243 242 243 242 241 242 243 242 243 242 243 242
291 310 310 310 310 533 180 212 212 246 246 533 743 745 745 745 745 745 244 33 743 745 745 745 8 775 745 745 745 745 745 8 743 596 6 310 310 310 310 310 310 310 310 310 310 310 310 6
244 310 310 310 310 595 452 424 421 424 421 595 775 776 776 8 775 776 291 200 33 775 776 776 746 778 776 8 775 776 776 746 778 628 596 512 642 641 642 642 641 643 641 642 641 642 641 595
291 102 743 745 745 627 422 420 8 420 423 627 8 775 776 746 778 776 832 833 833 833 833 833 833 835 836 747 778 776 776 776 776 628 628 544 547 546 546 578 546 547 546 578 8 577 546 627
244 743 777 12 775 627 419 423 40 423 420 6 747 778 776 776 776 776 864 897 866 866 866 866 866 867 868 775 193 132 132 194 776 6 628 544 546 515 8 577 578 547 546 546 108 675 578 627
291 775 777 746 778 627 422 420 423 420 423 244 1022 1023 166 1022 1022 1022 896 897 898 898 898 898 898 899 900 775 133 162 162 165 776 291 7 544 578 546 108 675 515 578 515 546 547 546 546 627
308 775 777 809 777 6 597 423 420 8 629 291 180 246 562 180 212 246 896 897 898 898 898 898 898 899 900 775 133 162 162 165 776 244 238 544 8 577 546 578 546 547 8 577 546 578 515 7
291 12 775 777 777 291 422 420 423 40 423 244 483 484 481 484 484 484 896 897 898 898 898 898 898 899 900 775 133 162 162 165 8 291 512 546 108 675 578 547 515 579 108 675 547 8 577 244
244 811 778 808 809 291 419 8 420 423 420 291 480 8 480 481 481 33 896 897 898 898 898 898 898 899 900 775 133 162 162 165 746 244 544 515 547 546 515 546 515 546 546 546 546 108 675 291
291 258 258 258 258 385 422 40 423 420 423 244 480 40 486 481 33 483 896 897 898 898 898 898 898 899 900 775 133 162 162 165 776 352 258 258 258 258 258 167 169 169 168 258 258 258 258 276
308 180 212 212 246 533 419 423 420 423 629 291 1022 1022 1022 1022 1022 1022 928 929 930 930 930 931 931 931 932 775 225 164 164 226 776 244 180 212 212 212 246 167 169 169 168 180 212 212 246 291
6 452 424 421 424 421 8 420 423 420 8 244 200 743 745 745 745 745 278 278 278 278 270 278 278 278 278 775 776 8 775 776 201 291 383 957 376 923 924 551 547 578 552 374 374 425 426 244
596 422 8 423 420 423 40 423 420 423 40 291 743 776 8 775 776 776 310 310 310 310 166 310 310 310 310 775 776 746 778 8 352 278 382 413 382 955 956 374 679 679 957 374 374 457 458 291
628 419 40 420 423 420 423 420 8 420 423 278 353 807 746 778 776 193 132 132 132 132 229 132 132 132 132 194 775 776 776 746 244 310 978 376 446 376 376 376 374 374 373 374 374 373 979 308
628 422 420 423 8 423 420 423 40 5 419 533 244 807 776 776 776 225 8 164 164 164 164 8 164 164 164 226 8 775 776 776 291 470 471 991 376 376 376 923 924 374 959 374 374 374 373 291
628 419 423 420 40 420 423 420 423 72 422 421 291 807 776 776 776 776 746 778 776 776 776 746 776 776 776 776 746 778 776 776 244 1010 376 441 1011 376 376 955 956 374 373 473 474 373 373 244
7 1021 1021 1021 1021 1021 1021 952 419 104 419 423 384 1019 1022 1022 1022 1022 1022 1022 1022 1022 1022 1022 1022 1022 1022 1023 384 167 168 384 243 278 353 446 479 376 376 788 725 725 789 505 506 374 374 291
244 449 418 418 418 418 418 984 422 420 423 8 533 180 212 212 212 212 212 212 212 212 212 212 212 212 212 212 533 167 168 533 180 212 244 430 376 978 788 783 783 783 783 789 373 957 373 308
244 416 33 480 481 417 202 984 597 423 420 40 421 424 421 424 421 424 421 8 421 424 421 424 421 424 421 424 8 424 421 424 421 424 244 430 472 376 917 883 377 377 820 787 373 376 373 291
291 33 483 481 481 481 1019 1016 422 420 423 420 423 8 423 420 423 420 423 40 423 420 423 8 423 420 423 420 40 420 423 420 423 8 291 430 504 376 852 376 377 377 376 852 373 373 373 244
308 449 33 29 30 480 417 417 419 423 420 423 420 40 420 423 8 423 420 423 420 423 420 40 420 423 420 423 420 423 420 423 420 40 308 430 376 926 853 376 377 377 374 885 373 373 373 291
291 33 483 61 62 480 417 417 422 8 423 420 423 420 423 420 40 420 423 420 8 420 423 420 423 420 8 420 423 420 8 420 423 629 291 430 376 374 885 376 377 377 373 852 373 373 373 308
244 449 33 93 94 480 417 417 419 40 420 423 420 423 420 423 420 423 420 423 40 423 420 423 420 423 40 423 420 423 40 423 420 423 244 430 927 376 783 789 377 377 850 885 373 373 978 291
291 33 483 484 484 481 1019 952 422 420 423 420 8 420 423 352 5 278 278 278 5 13 14 15 5 278 278 278 5 353 422 420 423 8 291 425 426 373 882 783 783 783 783 883 373 425 426 244
308 449 417 481 481 417 417 984 597 423 420 423 40 423 629 308 72 83 84 85 39 45 46 47 38 80 81 82 72 308 597 423 420 40 308 457 458 959 376 882 914 915 883 373 373 457 458 291
6 1022 1022 1022 1022 1022 1022 1016 422 420 423 420 423 420 423 290 74 115 116 117 74 167 169 168 74 112 113 114 74 290 422 420 423 420 384 352 279 5 430 376 376 376 374 959 5 278 278 308
596 455 421 424 421 424 421 424 420 5 419 423 420 423 420 6 957 518 374 374 704 768 768 768 737 475 476 957 374 6 419 8 420 423 310 244 311 37 491 492 492 492 492 493 37 310 310 291
628 419 423 8 423 420 8 420 423 72 422 420 423 8 423 596 705 550 374 374 740 768 768 708 374 507 508 373 704 595 422 40 423 420 424 291 449 418 167 169 169 169 169 168 12 449 202 244
628 422 420 40 420 423 40 423 420 104 419 423 420 40 420 628 768 705 373 978 736 768 768 737 959 373 373 704 768 627 419 423 420 423 629 244 416 12 416 417 417 417 417 417 463 450 417 291
628 419 423 420 423 420 423 420 423 420 423 420 423 420 423 628 768 708 373 374 374 740 768 705 375 375 959 740 768 627 422 420 423 420 423 308 416 463 450 417 417 417 417 417 417 417 134 308
6 240 241 242 243 244 243 244 243 244 243 244 243 244 243 7 736 768 705 472 374 736 768 708 374 373 704 768 768 6 240 241 242 243 244 241 242 243 244 241 242 243 244 241 242 243 244 6
533 180 212 212 212 212 212 212 212 212 212 212 212 212 246 533 978 740 768 504 959 374 740 768 705 926 740 768 768 533 180 212 212 212 212 212 212 212 212 212 212 212 212 212 212 212 212 533
