[A] Preview
30 40
591 591 592 591 589 360 362 589 590 592 591 591 591 591 591 591 591 526 852 884 884 855 724 28 29 30 525 591 591 591 591 592 591 589 360 362 589 590 592 591
623 623 624 623 779 360 458 779 622 215 184 623 623 623 623 623 623 626 727 884 884 792 160 60 61 62 625 623 623 623 623 624 623 779 360 458 779 622 624 623
419 418 28 29 30 456 457 329 425 329 426 148 94 24 29 30 29 30 759 884 884 855 756 160 359 160 417 28 29 24 29 24 29 30 456 362 28 29 24 29
419 418 60 61 62 360 457 454 489 454 362 120 126 56 61 56 61 62 793 884 884 884 792 417 359 160 160 60 61 56 61 56 61 62 360 458 60 61 56 61
419 418 416 360 361 457 457 458 417 456 454 425 454 425 454 425 362 759 852 884 884 884 726 160 555 426 160 523 362 132 454 460 359 395 454 454 361 454 454 454
418 160 416 360 457 361 457 454 425 361 454 454 454 454 361 454 490 793 884 884 884 884 758 576 577 456 329 454 454 489 454 454 454 361 454 454 489 454 454 361
419 418 28 29 30 457 457 28 29 30 454 361 454 489 454 490 759 852 884 884 884 884 724 608 609 491 454 361 458 417 456 454 454 489 454 458 417 456 489 489
418 160 60 61 62 457 457 60 61 62 454 454 458 417 359 419 795 884 884 884 852 724 28 29 30 160 360 454 454 425 361 454 492 160 488 361 425 492 160 160
418 419 491 457 457 361 489 454 457 361 79 80 81 425 492 757 852 884 884 852 726 419 60 61 62 459 454 361 489 454 454 394 160 589 419 360 458 160 589 160
544 419 416 360 457 458 417 456 457 457 111 112 113 362 333 334 334 334 334 334 335 459 329 454 454 454 454 458 417 456 297 160 160 779 160 360 362 419 621 417
419 419 419 491 457 361 425 361 457 457 457 457 361 454 425 365 366 366 366 366 329 454 361 489 454 454 361 454 425 302 492 576 577 160 367 365 366 367 759 825
546 419 544 419 491 486 457 457 457 361 457 457 454 454 393 397 398 366 398 366 489 454 458 417 456 454 454 302 165 160 160 608 609 761 367 397 398 367 853 855
591 592 591 591 494 419 392 457 457 457 361 457 361 492 333 334 334 334 334 334 335 491 454 425 361 302 165 419 160 193 419 761 825 853 367 365 366 367 884 887
623 215 184 623 588 544 395 489 457 457 457 457 492 419 761 853 884 884 887 589 417 160 360 454 165 160 160 160 417 757 825 853 884 884 367 365 366 367 889 724
328 454 553 460 588 459 458 417 456 361 457 394 160 160 793 884 884 887 724 779 160 132 454 362 160 160 417 761 825 853 884 884 884 887 399 397 398 399 160 417
456 458 416 358 86 457 457 553 489 393 492 416 160 761 853 884 884 724 28 29 95 452 361 428 419 757 825 853 884 884 884 887 889 724 160 160 160 160 160 160
491 361 425 454 118 489 492 160 160 160 160 160 544 793 884 884 792 416 120 126 56 452 492 757 825 853 884 884 884 884 887 726 417 160 160 160 160 160 160 416
416 456 454 454 588 544 160 419 160 160 419 160 761 853 884 887 724 160 160 485 489 490 757 853 884 884 884 884 887 889 724 160 160 160 160 193 160 160 160 160
459 454 454 361 525 592 591 591 591 591 591 526 793 884 884 726 419 160 160 160 419 757 853 884 884 884 889 889 724 160 160 160 160 193 160 160 434 435 193 193
361 454 454 454 625 623 623 623 623 623 623 626 727 885 884 756 160 160 417 757 824 853 887 889 889 724 417 160 160 160 416 160 225 160 434 503 160 419 502 193
454 454 361 458 418 28 29 24 29 24 94 30 418 729 884 852 756 757 825 853 884 887 724 160 160 193 160 160 160 224 225 225 202 203 416 160 202 203 160 502
454 489 454 454 425 60 61 56 61 56 126 62 160 761 853 884 884 884 889 889 889 728 160 193 193 160 193 419 160 160 160 132 271 271 195 132 271 271 133 418
458 417 456 454 454 454 454 454 454 454 361 428 761 853 884 887 889 724 160 471 193 193 416 193 193 416 193 160 160 202 196 271 863 860 859 271 860 859 271 133
454 425 454 361 454 361 454 361 454 454 297 418 793 884 887 724 419 28 29 95 466 193 160 193 193 160 160 501 416 296 271 860 852 852 852 861 852 827 271 271
491 454 454 454 454 454 454 454 393 428 160 761 853 884 852 498 160 120 126 127 471 470 160 578 579 580 160 533 132 271 860 852 852 852 852 852 852 859 271 271
589 456 362 589 590 494 454 428 160 160 418 793 884 884 852 856 498 419 303 193 417 578 579 580 611 612 533 132 271 860 852 852 852 852 852 730 727 852 862 861
779 360 458 779 622 588 362 160 418 160 761 853 884 884 884 855 856 532 172 578 579 580 611 612 611 612 468 204 271 766 852 852 852 852 726 417 160 725 889 852
454 361 454 489 454 497 454 416 757 824 885 884 884 884 884 852 724 500 193 610 611 612 611 612 580 533 134 271 860 852 852 852 852 728 160 148 94 95 193 725
361 454 458 417 456 497 362 333 334 334 334 334 334 334 334 334 335 578 579 580 580 578 579 580 612 468 296 271 766 852 852 888 726 193 193 120 126 127 193 193
454 454 454 425 361 529 454 460 397 398 366 366 366 366 398 366 193 610 611 612 612 610 611 612 533 232 271 860 852 852 724 193 193 193 193 132 271 205 193 193
